start_node,start_x,start_y,end_node,end_x,end_y,weight
[
            ("A",0,0,"B",1,0,1),
            ("A",0,0,"C",0,1,1),
            ("B",1,0,"D",1,1,1),
            ("C",0,1,"D",1,1,1),
            ("B",1,0,"E",2,0,1),
            ("D",1,1,"F",2,1,1),
            ("E",2,0,"F",2,1,1),
            ("C",0,1,"G",0,2,1),
            ("D",1,1,"G",0,2,1),
            ("F",2,1,"H",3,1,1)
        ]